Name: Maze 1
Size: 12
# # # # # # # # # # # #
# o . . # . . . . . . #
# # # . # . # # # # . #
# . # . # . . . . # . #
# . . . . # # # . # . #
# # # # . # . # . # . #
# . . # . # . # . # . #
# # . # . # . # . # . #
# . . . . . . . . # . #
# # # # # # . # # # . #
# . . . . . . # . . . #
# # # # # # # # # # # #

